#....................................................#
#....................................................#
#xxx.................................................#
#...........................................x........#
#....................................................#
#..b....................x......r..................x..#
#.."""......"""......""".x...."""......"""......"""..#
#.........xx.............x.................xx........#
#........x..x........................................#
#....................................................#
#......."""......"""......"""......"""......"""......#
#.xxx................................................#
#..................xx................................#
#.....................................x..............#
#.."""......"""......"""......"""....x."""......"""..#
#....................................x.......x.......#
#............................................x.......#
#..........................b.........................#
#.......""".x...."""......"""......"""......"""......#
#...........x.......................................x#
#...................................................x#
#............r......................................x#
#.."""......"""......"""......"""......"""......"""..#
#.........xx.........................................#
#........x..x........xxx.............................#
#....................................................#
#xx...."""......"""......"""......"""......""".......#
#xx..................................................#
#....................................................#
#....................................................#
######################################################
