#....................................................#
#....................................................#
#xxx.................................................#
#...........................................x........#
#....................................................#
#....r..................x........................bx..#
#.."""......"""......""".x...."""......"""......"""..#
#.........xx.............x.................xx........#
#........x..x........................................#
#....................................................#
#......."".......""......."".......""......."".......#
#.xxx................................................#
#..................xx................................#
#............b........................x..............#
#.."""......"""......"""......"""....x."""......"""..#
#....................................x.......x.......#
#............................................x.......#
#....................................................#
#x......."".x....."".......""......."".......""......#
#x..........x........................................#
#x...................................................#
#.......................................r............#
#.."""......"""......"""......"""......"""......"""..#
#.....................................xx.............#
#....................xxx.............x..x............#
#....................................................#
#......""......."".......""......."".......""......xx#
#..................................................xx#
#....................................................#
#....................................................#
######################################################
