#....................................................#
#....................................................#
#xxx.................................................#
#...........................................x........#
#....................................................#
#..b....................x......r..................x..#
#..""......."".......""..x....""......."".......""...#
#.........xx.............x.................xx........#
#........x..x........................................#
#..................................................x.#
#....."""".....""""....."""".....""""....."""".....x.#
#.xxx..............................................x.#
#..................xx................................#
#.....................................x..............#
#..."".......""......."".......""....x.."".......""..#
#................x...................x.......x.......#
#................x...........................x.......#
#..........................b.........................#
#......."""".....""""....."""".....""""....."""".....#
#................................xx..................#
#...............................x..x.................#
#............r.......................................#
#.."".......""......."".......""......."".......""...#
#....................................................#
#......................................xxx...........#
#....................................................#
#xx....""""....."""".....""""....."""".....""""......#
#..................xx................................#
#....................................................#
#....................................................#
######################################################
